F 111,0,152

C 143,232,120



NO ./textures/greystone.xpm
SO ./textures/redbrick.xpm
EA ./textures/wood.xpm
WE ./textures/mossy.xpm

1111111111111111111111
1
 1111111111111
10000000000001
100000000000001
111100000000011
100000000000001
1110000000000111
1110000000011111
10000001010100101
1000000010100011111111111111111111
1000000101000000000000000000000001
1000000000100N00000000000000000001
10000000000000000001000000000000111
11111111111111111111111111111111111