F 243,255,255
C 155,15,155
NO ./textures/colorstone.xpm
SO ./textures/redbrick.xpm
EA ./textures/wood.xpm
WE ./textures/mossy.xpm

111111
110001
100001
100001111111 1111111111111111111111111111111
10001
101001
 1111

 1111
100001
11N011
111111