
NO "./textures/greystone.xpm"
SO "./textures/redbrick.xpm"
EA "./textures/wood.xpm"
WE "./textures/mossy.xpm"

F 0,0,0
C 255,0,255

1111111111111111111
1001N00000000000001
1011000000000000001
1101000000000000001
1111111111111111111