111111
110001
100001
100001
100N01
101001
100001
110011
111111